...................
......fff..........
.......f.f.........
......f...f........
.....f....f.ff.....
.............f.....
.................ff
.................f.